NO ./assets/textures/wall_1.png
SO ./assets/textures/wall_1.png
WE ./assets/textures/wall_1.png
EA ./assets/textures/wall_1.png
DO ./assets/textures/door.pngx

F 12,30,12
C 10,10,40

11111111111111
     11D11
     11D11
111110000011111
     11D11
111110000011111
1DDDD00E00DDDD1
111110000011111
111110000011111
111110000011111
111110000011111
111110000011111
111110000011111
111110000011111
     11D11
     11D11
     11D11
     11111