NO ./assets/textures/wall_1.png
SO ./assets/textures/wall_1.png
WE ./assets/textures/wall_1.png
EA ./assets/textures/wall_1.png
DO ./assets/textures/door.png

F 12,30,12
C 10,10,40

11111111111111
     11D11
     11011
     11D11
111110000011111
     11D11
111110010011111111111
1D0D0D1D10E00D0D0D0D1
111110000011111111111
111110000011111
111110000011111
111110000011111
111110000011111
111110000011111
111110000011111
     11D11
     11011
     11D11
     11011
     11D11
     11111