NO ./assets/textures/wall_1.png
SO ./assets/textures/wall_1.png
WE ./assets/textures/wall_1.png
EA ./assets/textures/wall_1.png
DO ./assets/textures/door.pn

F 12,30,12
C 10,10,40

       1111111111111111111111111
       10N0000000011000000000001
       1D11000001110000000000001
       10010001D1000000000000001
11111111011000001110000000000001
100000000011000001110111111111111
1111011111111111100000010001
11110111111111011101010010001
11000000110101011100000010001
111111000000000001100000010001111
1000000000000000110101001000111
11111100111010101111101111001111
11110111 1110101 10111101000111
11111111 1111111 111111111111