NO ./assets/textures/wall_1.png
SO ./assets/textures/wall_1.png
WE ./assets/textures/wall_1.png
EA ./assets/textures/wall_1.png

F 12,30,12
C 10,10,40

11111111111111
     11011
     11011
111110000011111
     11011
111110000011111
1000000E0000001
111110000011111
111110000011111
111110000011111
111110000011111
111110000011111
111110000011111
111110000011111
     11011
     11011
     11011
     11111