NO ./assets/textures/wall_1.png
SO ./assets/textures/wall_1.png
WE ./assets/textures/wall_1.png
EA ./assets/textures/wall_1.png
DO ./assets/textures/door.png

F 12,30,12
C 10,10,40

 1111
1N0D1
 1111