NO ./textures/north.png
SO ./south.png
FL 220,100,0
C 225,30,0
111111
100001
1N0001
111111