NO ./assets/textures/north.png
SO ./assets/textures/south.png
WE ./assets/textures/west.png
EA ./assets/textures/east.png


F 220,100,0   


            
      C 225,30,0   

       1111111111111111111111111
       1000000000110000000000001
       1011000001110000000000001
       1001000000000000000000001
11111111011000001110000000000001
100000000011000001110111111111111
11110111111111011100000010001
11110111111111011101010010001
11000000110101011100000010001
111111000000000001100000010001111
1000000000000000110101001000111
111111001110101011111011110011N11
11110111 1110101 10111101000111
11111111 1111111 111111111111