NO ./assets/textures/north.png
SO ./assets/textures/south.png
WE ./assets/textures/west.png
EA ./assets/textures/east.png
F 220,100,0
C 225,30,0
FL 220,100,0
111111
100001
1N0001
111111