NO ./assets/textures/wall_1.png
SO ./assets/textures/wall_1.png
WE ./assets/textures/wall_1.png
EA ./assets/textures/wall_1.png
DO ./assets/textures/door.png

F 0012,30,12
C 0010,10,40

     11111
     11D11
     11D11
     11D11
     11D11
111110000011111
1DDDD00E00DDDD1
111110000011111
     11D11
     11D11
     11D11
     11111